*************************
*     *   *             *
* *** * * * *********** *
*   *   *   *           *
* * * ***** *** * ***** *
* *   *     *   *   *   *
* ******* *** *** * *** *
*         *     * *   * *
* ********* *** * * * * *
*           *   * * * * *
*** ******* * *** * * * *
*         * *     * *   *
* *** *** * *** *** *** *
*   *   *   *   *     * *
* * * * *** * * ***** * *
* * * *   * * *   *   * *
* * * *** * * *** * *** *
* *     *   *     *     *
* ***** * *** *** ***** *
*       *   *   *       *
*** *** *** * * * *** ***
*     *     * * *   *   *
* *** ***** * * *** * * *
*       *     *     * *L*
*************************