*********************
*                   *
* ******* ******* * *
*   *   *   *   * * *
*** * * *** * * * * *
*   * *   * * * * * *
* *** *** * * * * * *
*     *   * * * * * *
***** * *** * * * * *
*   * * *   * * * * *
* * * * * *** * * * *
* * * * *   * * * * *
* * * * *** * * * * *
* * *   *   * * * * *
* * ***** *** * * * *
* *     *   * * * * *
* ***** * *** * * * *
*   *   *   * * * * *
*** * ***** * * * * *
*   *       * * * *L*
*********************